1111111111111111111111111111111111
10>00000000000<C000v0C0v0000<000C1
1E10<11111100000101001000000011101
111001>C1C10101000100100000001C101
1Pv000001>00C0000^0000000<0001>0C1
10000001v01>00010000000000000000<1
10011111001000<10000<>0001>00C0001
1>00C1C0^00000000^00000001000C00<1
1111111111111111111111111111111111
