1111111111111
10C10C00000C1
110C011111001
1PC011E000C01
1111111111111