1111111111111
1>010C00000C1
110C011111001
1PC011E000C01
1111111111111