1111111111111
10010000000<1
10000111110C1
1P0C11E0000<1
1111111111111
