1111111111
1E00000001
1000100001
1010C00001
10100E0001
1000000P^1
1>00000011
1111111111
